                       0                       0
                       0                       0
                       0                       0
                       0                       0
                       0                       0
                       0                       0
                       0                       0
                       0                       0
                       0                       0
                       0                       0
                       0                       0
                          1W7G7S               0
                        1B    1B    1W         0
                        2B    2B    1W         0
        7D              3B    3B    1W         0
    7T  7U  7L7R7C7F    4B    4B    7K         0
                       0                       0
                       0                       0
                       0                       0
                       0                       0