                       0                       0
                       0                       0
                       0                       0
                       0                       0
                       0                       0
                       0                       0
                       0                       0
                       0                       0
                       0                       0
                       0                       0
                       0                       0
                       0      1W1G1G1T         0
                       0                       0
    1B2B3B4B           0                       0
    1B2B3B4B           0                       0
    1B2B3B4B           0                       0
                       0                       0
                       0                       0
                       0                       0
                       0                       0